R 501 500

NO ./textures/eagle.xpm
SO ./textures/bluestone.xpm
WE ./textures/colorstone.xpm
EA ./textures/mossy.xpm

S ./textures/pillar.xpm
C 0,153,255
F 0,153,0

11111
12221
12N21
12221
11111
