R 501 500

EA ./textures/eagle.xpm
NO ./textures/bluestone.xpm
SO ./textures/colorstone.xpm
WE ./textures/mossy.xpm

S ./textures/pillar.xpm
C 0,153,255
F 0,153,0

111111111111111111111111
100000000000000000000001111111
100000000000000000000000000001
100000000000000000000001111111
100000111110000101010001
100000100010000000000001
100000100010000100010001
100000100010000000000001
100000110110000101010001
100000000000000000000001
100000000000000200000001
100000000000000000000001
100000000000000200000001
100000000000000000000001
100000000000000200000001
100000000000000000000001
111111111000000000000001
110000001000000000000001
110000001000000000000001
110000001000000000000001
110111111000000000000001
11000000000N000000000001
111111111000000000000001
111111111111111111111111
