R 50000 50000

NO ./textures/eagle.xpm
SO ./textures/bluestone.xpm
WE ./textures/colorstone.xpm
EA ./textures/mossy.xpm

S ./textures/pillar.xpm
F 255,255,0
C 225,0,0

111111111111111111111111
100000000000000000000001
11000000000N000000000001
111111111000000000000001
111111111111111111111111
