R 501 500

G 10000 1000

NO ./textures/eagle.xpm
SO ./textures/bluestone.xpm
WE ./textures/colorstone.xpm
EA ./textures/mossy.xpm

S ./textures/pillar.xpm
F 255,255,0
C 225,0,0

111111111111111111111111
100000000000000000000001
100000000000000000000001
100000000000000000000001
100000111110000101010001
100000100010000000000001
100000100010000100010001
100000100010000000000001
100000110110000101010001
100000000000000000000001
100000000000000200000001
100000000000000000000001
100000000000000200000001
100000000000000000000001
100000000000000200000001
100000000000000000000001
111111111000000000000001
110000001000000000000001
110000001000000000000001
110000001000000000000001
110111111000000000000001
11000000000N000000000001
111111111000000000000001
111111111111111111111111
